111111111111111111111
100000000000000000001
101101110111011001101
100000010000011000001
101011000101100111001
100011010101100010001
100011011100000011001
101101110111011001101
100000010000011000001
101011000101100111001
100011010101100010001
100011011100000011001
101011000101100111001
100011010101100010001
100011011100000011001
100000000000000000001
111111111111111111111